# MAP 1
AD                                                                CAA
AD                                                                CAA
AD                                                                CAA
AD                     IIIIIII      IIIIIII                       ONA
AD                                                    EF           9 
ADIII     8       EF                 IIIIIII         EGD        IIIEB
AD       EF      2CD           2                    EGAD           CA
AHBBBBBBBGHBBBBBBBGHBBBBBBBBBBBBBBBBBBBBBBBBBBBBBBBBGAAHBBBBBBBBBBBGA