# MAP 2
AD                                                                                            CA
AD         IIIIIII              IIIIIIIIIIIIIIIIIIIIIIIIIIIIIIIIIIIIIIIIIIIIIII               CA
AD                                 1                      IIIII  CAAAAAAAAAAAAAAD             CA
AD                        IIIII                                  CAAAAAAAAAAAAAAHF   IIIIIII  CA
AD         III                          1    1  1                CAAAAAAAAAAAAAAAD            CA
AD                            1      IIIIIIIIIIIII               CAAAAAAAAAAAAAAAHF           ON
AD8          2  EBBBBBBBBBBBBBBBF                        2       CAAAAAAAAAAAAAAAAD            9
AHBBBBBBBBBBBBBBGAAAAAAAAAAAAAAAHBBBBBBBBBBBBBBBBBBBBBBBBBBBBBBBBGAAAAAAAAAAAAAAAAHBBBBBBBBBBBGA