# Map file for tile-based game 
# (Lines that start with '#' are comments)
# The tiles are:
#   (Space) Empty tile
#   A..Z    Tiles A through Z
#   o       Star
#   !       Music Note
#   *       Goal
#   1       Bad Guy 1 (grub)
#   2       Bad Guy 2 (fly)
AD         IIIIIII              IIIIIIIIIIIIIIIIIIIIIIIIIIIIIIIIIIIIIIIIIIIIIII               CA
AD                    2   !        2                      IIIII  CAAAAAAAAAAAAAAD             CA
AD                        IIIII                                  CAAAAAAAAAAAAAAHF   IIIIIII  CA
AD         III                          1    1  1        2       CAAAAAAAAAAAAAAAD            CA
AD                            1      IIIIIIIIIIIII               CAAAAAAAAAAAAAAAHF           CA
AD           1  EBBBBBBBBBBBBBBBF                                CAAAAAAAAAAAAAAAAD           CA
AHBBBBBBBBBBBBBBGAAAAAAAAAAAAAAAHBBBBBBBBBBBBBBBBBBBBBBBBBBBBBBBBGAAAAAAAAAAAAAAAAHBBBBBBBBBBBGA